###############   #
#       ## #  # #*#
# #### #   ## #  ##
#[   #  ##    ## ##
#### ## #  ##     #
#       ## #  ### #
# ######## ##   #]#
#             #  ##
###################
